0                                                                                                              0
0                                                                                                              0
0                                                                                                              0
0                                                                                                              0
0                                                                                                              0
0                                                                                                              0
0                                                                                                              0
0                                                                                                              0
0                                                                                                              0
0                                                                                                              0
0                                                                                                              0
0                                                                                                              0
0                                                                                                              0
0                  3333333333333333                                                                            0
0       11111121111                1111112111111                                                               0
0             2                          2                                                                     0
0             2                          2                                                                     0
0111111111111111111111111111111111111111111111111111111111111111111111111111111111111111111111111111111111111111